--|o--|----|--E---?-X-B---EM??-----TX||XB----|-T---T--?-X--T-|?----T--TTMo---TTTE-?-----E---X--T--M---B-TT--Eo-----B---EoBT-T--TE--?-o?M-B---E-EM--B-?--o--E-ME--?--B--X-o---M?--BX--?-MXE--o?-M-B?T-E--
-o-E--?-B?-M--------X-T|E-B-X----|-----|-B--|M-TB-o--o--M---T---|-o--XT?|-?-EE--|-o-T?ETE---oB?---B--?|--X-E-?E-----T-XX-o?o-MM--|-B---?----?E--T-?---X-X-|--E--BT-EE-BXT-----XT--o-o--oBBB------E--TTM-
---EXTBB-?---B----X-T-T--BT-o-o|MT------BE--?oT|?-----|To-EBX--Bo--oT-T-B-B---BX-|T-B|MT--X--TE--oB?--TT--E-o--o--E?--M-----EE-|--B-XM|-o-o|B-|B|B--Mo-|-M-?EMXT---M-E?||E--T--o-M-B-T|-|-|?ET----|---B-
-----T---E--?----EEB|X---o?M-------B-E?o-oMMXE-B?EB-B---B|-----MT---E--T-EEToX--MTo-X------X-----?-?---|T-BToM--TX|-T---M-----|-oX--o----oM||--X---?----o?BE--B-T----M-B?oo?B--X-o----T-EX------BMB--B--
-ME?E-??X?-M|TB--?|MX|---o-XB|E-|-E-M-----EBE-MB--oM--B--|o-MBBE-------B---T-|-X-B|B---?T|--|----o?|-|----|-?-TTE-XM------M?--?-|---oX--XT-B|-M?X?--E--T-|TT--?o--oTB--?M--------BT---MBo--Eo--B--B-T---
-BB-----?|-MT-oM-X---o|---M---TE-BT----M-EE-|E-B-----o---B?--?-----?--T-Xo----|Bo-o---X-M---?E--XM--o--E-Eo----M-T---B----M---X---|-M?-B---E-XME-MM?TMTX--X----|--|-B|o-|E-X--|---E|-B---?M-M---??--X---
--|--T-|----E?-?E-E-XT--|----M-B---o--E----|-E-?o---BT-B?-T|X-XMX-------X--X----|----B--M--T--?|T---TX--?X-----|----|----oB?EM-o--?----B-T---oo---X--?----Eo-T-BoT--o---o-o--XE|-EME|--B-E|B---B--MTo---
-XET-T-EB----M|EME--?o-||------X-----M--M-----?E?ET--XE|T-T--MB---B?-X--T?------o--B---X-?-|-----------o-E---o--E--o-BM----MB?--MB-|o-|M----X-|-EooBXM-T---?|--EXBEXo?T|T---M-o-o-o----B---?-o-----|o-Bv
-o--?----Bo?T-|-----?--B?T----E-MEBTX-E----M-?-?T---MM-----E-----B--E-E?X?--|B-|-B---|-M-------BoM?--MXT--||---TM|-----o---?----|-XT---|--M--EXTE?|-o--X---M?-M-X----TE-BBo-X----o--o--o-M?--o-----XE-Xf
-B-----M-EE------|--M---o-----|BM---XXE--|--EX|T-EX-o-|-M---M--?X-----Mo-T?|--T-T||B-o-M----X-To-------X-B-T|-o-----X-B---T-B-TBo|--|-EE--?---E?--M--E|--o-T--M--TT--|-M|--X-XX--M-X|M--B-E|-----?--X--f
--?----o--|---?-E--o---E-EE---X-B----T-EoB---M---?oX-?-M----E-B----M-o----T----E-|-B--B-E|-|--?-TM--X-X--o-|-T--T|B-X--X-T--o-T--TM-B-X-EM-T---E-M--MT--MoMBE-o-B-T-TB?--?-|B--X---EoB----X--ET-???X---f
--------o---T----E---oo??-T-XT|oT|o--E------|XEE-----|-----?o-|----EXT|----M?-|T--E?MB--MX--E-?-E|-|----B-EEE-M|---BXXB|---B-BXTX?--M-----X---T----X---T---BM-?XX||o--ME-o--oEE---oX----EM-XToE?T|----|f
---B-o--?--|-?EE---M-XT-E-B--T-X--B-B--|?-o-----ET---|o---MEo-T-M----E---?--B--MB---|BE--E-MX-T----XET-B--|-E--oB---E-o-----o?M-|EMMT-M|--M----M--?--E-------E------o-|X-----T-E-MMB-M--XX?B--------E--f
--|-----o--X-----E|--BT--?---TMEE---|BB-Eo||?T--M---?-|T-|X-----?------T-?X|------oM-o|M--T--?-M-M-oB-||-E---XBET---B|X-E?---Mo??----TT--|--MX|o--oT|T--o--B?------|o--EXM|-----E-|--o--M-T-T----T-M-EEf
mB|?--T---M--o-E---o---?------?---BEEE-?---T-|----?|EETM----T-?EX-ME---?--E--?E-|-X-----T--------M-T--M----|---o--?-X--MX--B-X-?-M|E---XX-M-B-M-|-EE------X--M---|o?|MX--|-M--T|----oM-?-BB--Mo-X?-XE--X
XXXXXXXXXXXXXXXXXXXXXXXXXXXXXXXXXXXXXXXXXXXXXXXXXXXXXXXXXXXXXXXXXXXXXXXXXXXXXXXXXXXXXXXXXXXXXXXXXXXXXXXXXXXXXXXXXXXXXXXXXXXXXXXXXXXXXXXXXXXXXXXXXXXXXXXXXXXXXXXXXXXXXXXXXXXXXXXXXXXXXXXXXXXXXXXXXXXXXXXX
