-Xo---|--------|--?-XM-X----MMo?-T-TXE?--BB--T-T--BT|X--?|Xo--X?XMo-oBM-?BX-BEETE-X--?MEE--?MB-?-EX-E-B?TT|--oB-B--X-T?X|-T-TX---||M--?M|-XXE--Eo-?-E---oE?X?MEoTT--B-|B?o-BT-|E|BXBM-?EX?XToEXM-B------
-??|X-B?M-X--??X|-----BEE|EoM-E??|-o-M||-o---TTTB--|-?--M-T-Bo|-|-o-TXX??M||o-B?X-o--|-B-X-?-BE?|TB-|EX----E---B--E---TXE-?o--MT|-?---TM?---M?B-T|To-T--XT?-TE-BB--TE-T-T--o--E--X--BM-o-B--TM|MB--TTM--
----|oEXM|?BMT|-T|TET|MMMXo?-Bo|M-Eo-MB-B?--?--|E?-oB?oTT-Eo|o-X-|?o---B---MXX-oMM-E-XMoM-oo-XT?-o--o---o|MX--MB--??BX--T-----??X?-?---oM?o?BTTE--BEo?M|BX-XE|-TE-B---?-?E--X---|-|-TT|--?--E|-MX-|?-EB-
-MTTTTM-?|-??-BB-MET-oXo--?B-o--X|-BTE?oEo|---B-X------XX|---??|--T|E?---MTToTEX----XEo?TXBoE?o--oXM--|E-B-To---?---X-X-Eo?M?BE---M?---EoX-----o-T----XB|X|E-BBEo---MXMBMooEB-?X-o|-----MME?----M|-E-|--
-oBTE-?|X?-M---E-?|MXT-M--BTB|MMEME-T?X-E?X?TM|M-TEM-X-o-|-B-|oE-B-o?|-BEEET---B-|o--|?-T-|-o-|MB-?|--M-XE-?-MB-EooEX-X-|-B?-|?--XEXTXE-TT-BE-B?XT--E--B-|T?Eo--MM-TTBT|-T--X-B-EoT|-XM-T--XX-EB--o-oBE-
-|?B|-|-?|-M--o--|X-ETX---B-T-EX?B-B||-M-|M--o----T|-TB---------M-M?--TEET?--o|B-E-MX---MM-T-----X-oB-M--EE-XEMB-?--o---MBM|--M--|-XBo-M|B--o-MEX-M?MM--X?ooEo-XX-|-E|o-|B|X?o|?oT|T-X----XT-E?----o--|-
--|E-E----M|T--|EBM-XoE-T--E?M--EMoo-TB-?o|M-|E-o---ooXET-TEBoTMB--T----o-?--o-oX---|B-MB--|--?oTB-|-----EoMEB-|--MM--XX?o--XM----?o-EEo-M|B-T--E-XE-E----EB---?--M-o-----oXMXEX-EE--?XT---B-?TM-XMT|---
-|?Xo-------oT-B-E-B?-o---?--|---TBE-MM-M?T-o|MEE-?-ET-B--X?XX-M-o-|-X-|MXE-|---||--o-B-ME--?---M-X-oE-T-EBBEoX-E--o-ooTB--o|?BoT|T|--T------T---o|BoMTE-----EEE-BEo---|E---M-o-oToXE--M--||--|??-MMM-?v
-o---|-?-X-------XX|---oMX-TBM|-?XE-oME?---X-?TX-E-?MM-B---E--?--B-|E-?-Xo|-MT-|-B|?oT--B--E--MBBo?Mo-XB--BT---Bo||--E-?-BEXM|---oB--BET--MMoB|BEEX-MXM?--To--E-?o?---?--|o-MEB-oM--oooME--|-oMT--Xo--Xf
-BB-T-----------T|M-M-X-T-|TT-o|-X-BE--|XTX-Bo-TMBX---EM-o---|--X-----?|-T?XX-TMTo-BoT-X-|XB--MTo-E-?|--oX-T|-|ToMMo|-XT--M-oEEBoE-M--E-|BE----?--?-|EE---ETM-MTM-TE--E--X-XXT--|X|||MBB-ME--EEMT---E|Xf
-o---BTo--X--E-o-B?-------??B-EooT?TBT?Boo----o--M-XTM-E-oE-E---E-----XM-M--|--M-|M-?--oo|-M-EXBM-BoX-M-B---EM--BXE?B--?-|B?-E-|-TE-BB?|E-??-TBMT----TT-|o-?EXo-B-E-T-TX-MBo-|?T--E|M?T----ooE-M--TX--Ef
--|BX-MTB|oBE-EEB?-o-ooT-XB|XMX-|?--TE---T||-|o|T-XM-|?---|?-ET-|---XT|-oTET?oX|--E-EBB--?MoXE-?----E|o---ETE-M--?-X---B-|-B-o-TEX-?MoXToB?-M|B-|-E-|X|TM--EB-?X--To?o-T-E-BX----?BM-M?T?---XoE?T---|MBf
----TXBE|--|B?T|--|M--B---MT-?-XM|o-|---T-E---T|E-?X-|o---ME----??|o-----?-------Bo-|?o---B-o--|-|X-EB-E?X--B--oE---E---|-Xo-?----MXBBM---M-T|?EE|?-TM----BoX|EMX--?B|?X-?|-?--|MoX-XMMXoB-BMoET|E-TM-Bf
---M-----??MB?-|?-|BXX--o-M?-E?XEo---|E-BMo--TM-M-?-?-|BB|--X----X-EMMB-E-ET-B?E-?-XEo-M----M?-MM---|E||-E|-M-EM-T-XE-|--?MXETB-Mo|B-?-MT-BMMo-B--oMTTBE|---M--X|T-|--XBoM|?B----XXo--MB-|T|T-o|T--Bo-Ef
moo|B-M--MM|--o--?EoTT|??M-TE-MB-MBE--?--|??X-BM--T-o-BM?M--T-E-|?MB?BE??-X--oEE----TE-----X--MT----M-oTEE----MX?-B-----BE-T-|-oBM-E-XE-X?-XT?M-|?E-XXE-E?E||EMMBXo-|MBMEM-M-Xo--M--o-o|MXo---B-E-MoE-|X
XXXXXXXXXXXXXXXXXXXXXXXXXXXXXXXXXXXXXXXXXXXXXXXXXXXXXXXXXXXXXXXXXXXXXXXXXXXXXXXXXXXXXXXXXXXXXXXXXXXXXXXXXXXXXXXXXXXXXXXXXXXXXXXXXXXXXXXXXXXXXXXXXXXXXXXXXXXXXXXXXXXXXXXXXXXXXXXXXXXXXXXXXXXXXXXXXXXXXXXX
