--------------------------------------------------------------------------------------------------------------------------------------------------------------------------------------------------------
------------------------------------------------------------------------------------------------------------XX-------------B----------------------------------------------------------------------------
-------------------------------------------------------------------------------------------------------------------------------------------------------M------------------------------------------------
--------------------------------------------------------------------------------------------------------------------------------------------------------------------------------------------------------
----------------------------------------------------------------------------------------------------------------------------------------------------X---------------------------------------------------
---------------------------------------------------------------------------------------------------------------------------------------------------XX---------------------------------------------------
--------------------------------------------------------------------------------------------------------------------------------------------------XXX---------------------------------------------------
-------------------------------------------------------------------------------------------------------------------------------------------------XXXX-------------?------------------------------------v
----------------------------------------------------------------------------------------------o-------------------------------------------------XXXXX--------------------------------------------------f
-----------------------------------------------------------------------------------------------------------------------------------------------XXXXXX--------------------------------------------------f
----------------------------------------------------------------------------------------------------------------------------------------------XXXXXXX--------------------------------------------------f
---------------------------------------------------------------------------------------------------------------------------------------------XXXXXXXX--------------------------------------------------f
---------------------------------------------------------------------------------------------------------------?----------------------------XXXXXXXXX--------------------------------------------------f
-------------------------------------------------------------------------------------------------------------------------------------------XXXXXXXXXX--------------------------------------------------f
m-----------------------------------------------------------------------------------o----------------E----E-------------------------------XXXXXXXXXXXBBB--------X-------E---E-----X----E---------------X
XXXXXXXXXXXXXXXXXXXXXXXXXXXXXXXXXXXXXXXXXXXXXXXXXXXXXXXXXXXXXXXXXXXXXXXXXXXXXX--XXXXXXXXXXXXXXXXXXXXXXXXXXXXXXXXXXXXXXXXXXXXXXXXXXXXXXXXXXXXXXXXXXXXXXXXXXXXXXXXXXXXXXXXXXXXXXXXXXXXXXXXXXXXXXXXXXXXXXXX
