-?-?--?--X--|-----oX----B-E-T?M?--?-|B-XTB----------|?E-?EoT-----||----T-----T----X|X---E---XXX--E-----?BTE-?--TB|-X--?E|B-M-----B-M-?-X-EX----Mo-------o---?M-?-X--B--T-?--MM?E-----??---Xo-E----TB|o--
-X-T-|----XEE?-o--EE--BE--ooMX?X-M-o-B-TMB-?-M--B-o--?|-MT-EB---|---?X-?----EB---M-----ME--o-E-EXEM---T--XM--|--M----|-B--o-----ooE--To-?------T-|E?--TX-T?T----M--E----T|-B--o---T-oETB-TBET--B----X---
---------oX--T----X------X-oX--|--E--TX--?--E----|-M----T---X---oT-o---BX-------M?T----E--ooo-E?-B-M-------T------?-|---EM---T-M----X----?--M-oB-B--o---BE-----To|BMoE------X----M|-----|?o--|-M-|-M--?-
-----o-X--B---X--X-|-X-----|Mo-B-X----?BBB||XTB-?-E--B-?M--B?--M----------oB-ooX-T-M----TBB--?-B---E-B-|---||-B--EB-X---------|ET--o--o--oo-|--o-T--X--o--E-T-o?o|-M---Eooo------o--XT-|MM-o----M-XE--T-
-oB?--B-Mo--MM?-|T?--M-M----X|o??------E|---B-BT-T---B?--o-T-oTE--T-oTT--E-----B-B?B--E-----M-----M?----MME-?-B---XMM-B||-X---?B|-E-----BT--oTB-X-|--BX----EEX-M---BTTT----MX-B--o----------X--oX-------
-??---|T-----X-|----ET--?-----?XXM---|-E?|---o-M--BE-EB---B---?|--------Xo-----X----X-M--X-X-?-|-XE-o----Eo---M-BT--T|--?-TT|E?----|B?---MXX|--?-XE||--XB?-?-o--T-------o-----|-|E-------BoTX---|--B----
---EM----T-BE---X|---o-?--?--|---M-----M---M---?--X--EX-o--|----X---M-|----B-oX-|----o-----B--X-T--MM---|--?M--|oEMM-?X-E-||XEBE-----E-o-??-------oX-|--MTMB---BX-E-TT--|-|-----?----?-T?--T--X----oEo--
-E---EXE--T---|E--B-----?-------X---TX-B---o-|Mo?-TT---T-BoT-X-M---|B---BX--B-------||||-?---ETMMBo-o-T---BBB-B-T----B-X|E-o?-M--|-|--|-?----|--|-o-oE---?----|EX-E--BTo|--?---BB?---o-|o-EE--o?-?--o--v
--------|-o-B-M-E--?-X-o-T-T?E-o?|EB?M|----M-|E------oBBB-----?-Mo-MET-?-o--o--?--||-T--T||-----BB?--B---|XTE--MMBX-----T-|----T--B----o--M-oBBX|MTB---?---|?|--|o--------BTMEB---TXo-o------o----X-To-f
-|-o---MX-||---|-|EB-M--o-o-T-o|EX-XX-------BE---ET-o-E-M-|--|-|------?|T-XME-TB--B----o----M-B------?o-oB--oB||M--B|-X---EXE-TT?E-|--M-E-E--B----?---E|---TM-TB-----?-X--T-BX?-|X|o----Bo--o---MB|-E--f
-o-----o--o?--T?B----------?--X--T-T--?-oBT------M--TMT--T----M---?|E--oE-B-|--X-B-B-E--M--MB--?X-B--?--E---M-X-E|--T----|-|-E------?--E-MX-TBB-M--M--?--oo-o-M-BE-----M-o--M|--o-M---|-B?E----T----X-Ef
-?-BXB-T----T-X-|?----o-?-B|-M|-M----E--oM-XEBo?--XM--?--X---E---|-E----o-EEM?-|------?---o-E---X--XX--MXX----?--??-XXE--T---X--?--|-o|-BE?T-|-MB--M|----E-XEoB?X-----EM-oE-X---M|-M----?Bo-BT----X-|--f
--|-TT-E|--E-XTE--|-MB-XX-oT-?TX--BTB--XT---X---o-Bo------?|EBT------?---T-X-o---B---?o?o---oMTM--?--?-M---BMX-oEMM?B-E-o-?-o?-E---M-B?-TM-TT--E--B--X---XB--E-MX--TB|-M-----M-|-o|--To-X------T|?--Eo-f
-?-T-T----?---T??T|-XXB----?-T-X---M-BTE-o---M---E---E-T|---------o-M?B-E-E|BBM-MB-oo-|o-?-E-M--M---|-|--o-?M--E----E|---?|-----o-Eoo??-M--?TB--?-MM---E|-X|o-BM-M|T-------?---------o-----|BE--T-BBo|-f
mM--B-XB-EX-|-o-oB-B---M-?--E-T-o----|E--?o?---MXTTE-?BB---|---B|T--XBB-B-XE--?-ToE-TE--T|oX--?---|TM-o--X--M-----B-|o-XM?-T-B-o--Bo---B-oM-o?-?-?-EEE-----B|E-M-|-|-XB?---EM----M-----|---E---B--M----X
XXXXXXXXXXXXXXXXXXXXXXXXXXXXXXXXXXXXXXXXXXXXXXXXXXXXXXXXXXXXXXXXXXXXXXXXXXXXXXXXXXXXXXXXXXXXXXXXXXXXXXXXXXXXXXXXXXXXXXXXXXXXXXXXXXXXXXXXXXXXXXXXXXXXXXXXXXXXXXXXXXXXXXXXXXXXXXXXXXXXXXXXXXXXXXXXXXXXXXXX
