--o--MBX---|--EMo-?XXM----E-To----BE-|-XXM-oX--XEX|T----BE---|--?--B-T-XM-oE-T----?--oT-XT--X--T-MoM-oB--o?-T--B-E----oXT---M-?T--o?---M---X-E-B-----?-?---|-M?-X?--B--------M--|----o?MX--ToE-MXE?X----
-|XBXE|-B--BX?----T--B-|---XX--|?--B----Bo--TM--BMoTMXE||-?X|-|To-XB--X---M---M|XE-TT--|E--?MX----B--?X---EB--?|---?-TX--o-?--M-B|---|--|-X--BT-T-BEoB-oX-?----------oB-M-----XTT-X-o-To-BBE----E-E-T---
-----T--------B---X---XB-BX??o--MT-----X--o-o-?|B|---B-|---BX---o--|--T?--B----BE|T-B-M?B----?-?-E??X-?E--T--M||TB--B-MT-X--oE--E|--------oXB-EBTM-EB----M--E-----M|-E-||----B---MTTT---|?|-E---XoT--Bo-
-E--TTBXB-----o-BMET-o---o?M|?E-?-T-?-?o-ooMX---M-E--|--?oM|--oT|---E-?TT-M---|-?To--?--|--o-BX-|-|-B-|MT||-||--TX|-T|T?--?X?T-?o--X--T---Mo|-BXT------B?XTE----?-??--------MB-B-o|---XoE------XBT-o----
-EBo--o-EM--MBMEB||EX||M-oX-M|ET?o----X-o-?BM-T---Eo--B--MoT-B----o--B-B-----|EX-B-B|-?-----|T---o?--o-?o-|B?--|E-XMMBE--EXM--X-||--TT-----B----X--M------TETE?-MM-B-Mo|-E----X-TET|E-XBT--oEE--T-B-----
--E-o-|--|TM--oB---TTB--?-E-ET----M-|?TM|-E--E-M|Xo-MoX--B--|X-|---?--B-Xo-T-T|Bo--|---M---M-E-B---Moo?---o--B-M-XB--B-M--M---------M------ETMMM-XE?|-X--EX|--EXTMM-Eoo-T--B--|----oB----?T---?-?--|----
--X??E-E-|E-E--?EBE--T-?--?-?E-B--------B--|---XE-B-o--E||T|-XT-E--oo--------X--M-----oo?B-||M|oTo------?X-B-XME---oX-X--oM-EBBoB-----Eo?---?o--o----X---X-o---?X---oE--o----X-o--|E|E-B--|BE--X-o?-|?--
-|-T-?-ME?---XMT--|-?-o|--?-------EX-M--E----|MEo-T--XET--?--XBT|-B-T-B-TM-----|X--B---|-?-M|--Bo-X---B---------B---EB--B-EMBE--|-T-EE|M-XT--B--Eoo?T-M-T?--X-EEE-EE|?TMT---MBoMBMX---XMME-X-To---|-o--v
-o?B-X?--o-?o-T-----B-M|?E---M-oM-BBX---M?-X-?o?|----o?B---------B--EMEMX?E-o-B-oB-Bo-E--|--X--BTX?-EMMM--||E?|?o---M--?E-B-o--X--oT---|--?E---E-?B-oX-MM-----M-T----TE--MB-o?ME-o---|||TM---?TTM--X-oXf
-|-----M?EE--?----o--?-ooTB---oBB-----ET-?---T-T-EMTo|M-BBE-MoE?T--o--M|B-T|--T?T|X-E|?X---B|-T---X----E?-M--XX--B-----|-oX-BoBB-E-M-T--?------M----o-BX--o---MT-----?-M-BB-M|---M-o|--EB?--EX-|E---Xo-f
--|--|E?M-XM|-?o----E|E-|-----XE----Bo-BMB---X---M-|-XM-E--T-oB-E-|M--T|o----E?E-T-XE-B-o?-|-E-XX-BMX-?X---?----B|BBMB-X------o--TM-B-XEXE-T-?|E-|-EMT--BoXB----B---T-?--?-?-|-X--E-o-T-T---o-X?-|?X---f
-|------oX--o--T-||E--X|?XB-E?|--Xo-TB---T-B||EMM-----?XB-----o-|-XE-T-----Eo----M---X-|-MoB--|MXX-o----BMBEE-?B-M-B--B|X-|B-B-o--?----T-E--B-T---BB--?-----T-?XX-X|----T---XE|-|?------E--TTT---|-E-E|f
--|---TT--oo|M-E---B--TX--o-o-|?----E--|--TE--E-ET--BMo-?BM-EMT-----??--?EB|B--T-?--|--M--T-o-BE-?|XTE-B-T|??------?B--|-o--B-E-o-XMTo?--X-TB-|MT-oM-E-----oo---T-oB----?-E--TE||oM-----X-B-MoX-----?-Mf
-o|-ooB--?X-E--T?-|M-X----MTX---To---B----B?-MT-M-|-?o|---M|-B|--E-M-X-T--TT--?-o---X-?BT-ToXM-B??--B-||-E|M--BETBo-B-X-?M--X-BM?----TM--|--|X-M--oE|o--o--B---Mo-----TTo-T?-E--T-|XM-o-XM-?-oB---T|---f
m--M-MT-?--B-oEE-ooTE---------T--TM?--B?--XT-BT?-----?EM?TM-TM?B-T-E-?-X-----?ET|-XT-M-oBM----E--ETT--TTM?-BM-TT---------o-BE|-|--|M---X--M?BE--o?oE---T-XX------|o-Bo|--|-BE--T-o--o--?M-EM--Xo-------X
XXXXXXXXXXXXXXXXXXXXXXXXXXXXXXXXXXXXXXXXXXXXXXXXXXXXXXXXXXXXXXXXXXXXXXXXXXXXXXXXXXXXXXXXXXXXXXXXXXXXXXXXXXXXXXXXXXXXXXXXXXXXXXXXXXXXXXXXXXXXXXXXXXXXXXXXXXXXXXXXXXXXXXXXXXXXXXXXXXXXXXXXXXXXXXXXXXXXXXXX
