-----------------------------------------------------???????--------------------------------------------------------------------------------------------------------------------------------------------
--------------------------------------------------------------------------------------------------------------------------------------------------------------------------------------------------------
----------o---------------------------------------------------------------------------------------------------------------------------------------------------------------------------------------------
----------o---------------------------o-----------------------------------------------------------------------------------------------------------------------------------------------------------------
--------------------------------------------------------------------------------------------------------------------------------------------------------------------------------------------------------
--------------------------------------------------------------------------------------------------------------------------------------------------------------------------------------------------------
--------------------------------------------------------------------------------------------------------------------------------------------------------------------------------------------------------
-------------------------------------------------------------------------------------------------------------------------------------------------------------------------------------------------------v
-----------------------------------------------------------------------------------------------------------------------------------------------------X-------------------------------------------------f
-----------------------------------------------------------------------------------------------------------------------------o-------------------X--XX-------------------------------------------------f
---------------------------------------------------------------------------------------------------------------------------------------------------XXX-------------------------------------------------f
--------------------------------------------------------------------------------------------------------------------------------------------------XXXX-------------------------------------------------f
--------------------------------------------------------------------------------BBBB-------------------------------------------------------------XXXXX-------------------------------------------------f
------------------------------------------------------------------------------------------------------------------------------------------------XXXXXX-------------------------------------------------f
m----------------------------------------------------------------------------------------------------------------------------------E--------E--XXXXXXX-------E-----------------------------------------X
XXXXXXXXXXXXXXXXXXXXXXXXXXXXXXXXXXXXXXXXXXXXXXXXXXXXXXXXXXXXXXXXXXXXXXXXXXXXXXXXXXXXXXXXXXXXXXXXXXXXXXXXXXXXXXXXXXXXXXXXXXXXXXXXXXXX--------XXXXXXXXXXXXXXXXXXXXXXXXXXXXXXXXXXXXXXXXXXXXXXXXXXXXXXXXXXXX
