-----------------------------X--------------------------------------------------------------------------------------------------------------------------------------------------------------------------
-----------------------------------B----------------------------------------------???????---------------------------------------------------------------------------------------------------------------
--------------------------------------------------------------------------------------------------------------------------------------------------------------------------------------------------------
--------------------------------------------------------------------------------------------------------------------------------------------------------------------------------------------------------
---------------------------------o----------------------------------------------------------------------------------------------------------------------------------------------------------------------
--------------------------------------------------------------------------------------------------------------------------------------------------------------------------------------------------------
--------------------------------------------------------------------------------------------------------------------------------------------------------------------------------------------------------
------------------------------------------------------------------------------------------------------------------------------------------------------------------?------------------------------------v
-------------------------------------------------------------------------------------------------------------------------------------------------------------------------------------------------------f
------------------------o---------------XXXXXX---------------------------------------------------------------------------------------------------------------------------------------------------------f
-------------------------------------------------------------------------------------------------------------------------------------------------------------------------------------------------------f
----------------------T--------------------------------------------------------------------------------------------------------------------------------------------------------------------------------f
-----------------X----|--------------------------------------------------------------------------------------------------------------------------------------------------------------------------------f
----------------XX----|--------------------------------------------------------------------------------------------------------------------------------------------------------------------------------f
m--------------XXX----|-E------------------EE----------------------------------------------------------------------------------------------------------------------------------------------------------X
XXXXXXXXXXXXXXXXXXXXXX|XXXX-------XXXXXXXXXXXXXXXXXXXXXXXXXXXXXXXXXXXXXXXXXXXXXXXXXXXXXXXXXXXXXXXXXXXXXXXXXXXXXXXXXXXXXXXXXXXXXXXXXXXXXXXXXXXXXXXXXXXXXXXXXXXXXXXXXXXXXXXXXXXXXXXXXXXXXXXXXXXXXXXXXXXXXX
