--------------------------------------------------------------------------------------------------------------------------------------------------------------------------------------------------------
---------------------------------------------------------------------------------------------------------------------------B----------------------------------------------------------------------------
---M----------------------------------------------------------------------------------------------------------------------------------------------------------------------------------------------------
--------------------------------------------------------------------------------------------------------------------------------------------------------------------------------------------------------
--------------------------------------------------------------------------------------------------------------------------------------------------------------------------------------------------------
--------------------------------------------------------------------------------------------------------------------------------------------------------------------------------------------------------
---?----------------------------------------------------------------------------------------------------------------------------------------------------------------------------------------------------
----------------------------------------------------------------------------------------------------------------------------------------------------------------------------B--------------------------v
-------------------------------------------------------------------------------------------------------------------------------------------------------------------------------------------------------f
----------------------------------------------------------------------------------------------------------------------------------------------------X--------------------------------------------------f
----------------------------------------------------------------------------------------------------------------------------------------------------------------------------------------X--------------f
-------------------------------------------------------------------------------------------------------------------------------------------------------------------------------------------------------f
--?--------------X-------------------------------------------------------------------------------------------------------------------------------------------------------------------------------------f
----------------XX-------------------------------------------------------------------------------------------------------------------------------------------------------------------------------------f
m--------------XXX-----------------------------------------------------------------------------------------E-------------------------------------------------------------------------------------------X
X-----XXXXXXXXXXXXXXXXXXXXXXXXXXXXXXXXXXXXXXXXXXXXXXXXXXXXXXXXXXXXXXXXXXXXXXXXXXXXXXXXXXXXXXXXXXXXXXXXXXXXXXXXXXXXXXXXXXXXXXXXXXXXXXXXXXXXXXXXXXXXXXXXXXXXXXXXXXXXXXXXXXXXXXXXXXXXXXXXXXXXXXXXXXXXXXXXXX
