T---?M--EM------E--|-M-----MT?o?--?TX|-?BX|----o|----X?M---?--??-B-TME--?----TET----T?M-EX--MB---E-|--X--T-M-M-|--?XoT-?-BT-----TE-M-o?T-BX--E||----TM--EE-X-ME--?--B--X--EB---o|------?--B--EEM----|o--
?|?-?|-B--X-E-?X---E------?-MXM?-|-BE---Mo---TTT?TT|-?|TX-TTBo|-|-T-TX--o?M-o----oo--|-M-----X-E|-M-XET--XX?MM--o?--o|-BE-o-X--T--?---oT?------TE|-?-o---EoTTB--MT-E-------B--XB-TT|oETB-TB-TE--B---X--B
o----E---o??-|T-------M-MX--XBo|-?-ooo--B?-?B--|X--T-|-T---------M--E-o----MX--|MXTE-|?E?BX-BMM--o-M-|--B|EX--XB---|-----M-T?--M----X-T-TX-----B---Eo?---TB-EM--|--|-----|M-----------|-|?-?-|--||BE--?M
?|-|-T|BB--?--oB-XMT|o?o-B-B----Xo--ME-oE-M---T-X-E-----ToMB---B?-M-E|---M-MEo---?-oX?--|XB-X|-B|-|M--|B----oB?--EBMX---?o??-B|EE-MooT-E-o-T---o-T---XXo--B--BB-B--MMX--o---B--X-o-X-E--MX-o-?--M|X--B||
-o-|||?-???MM-?-|?|E---M--B?-B--T----?--E?----|?-To-T-E-To-T||To-B-o-|T-E-----TX-X-B--E---o-o-E--To--B---E|T?-?---o?M|EX-BBT-|?--MMoT-?---X-E-M-|-|oEBEB-|ET-X-M---TT-TE-X--------T--XE-T---X?E-------Xo
E??----T?-|M-X-----?E?X--|-|To?-?M-----M-|?----B--BE-BB---?--T-|--M??E--X|X-----------X----T----X-X-o----EE-M--B-?-B------T|-E--|-M--oEE-?X-|-MM?--|--MXE?oo--M|T-|-T------|--|Mo-|?---------------B--MT
B-M|-----T-B----TT-XXo--E-?E?M|-------BX--E-o|E?--XoMEMT|--EB-E-Bo?X-E--X---E-Xo|---|-XMB----TX-T--M-T---B--?X-Bo-o-M?|-?E|-XM---MMMB---|-?B--?EEBo--E-----|--X?o-M-?T------BXEX?-M----T---T-?-M-?M-|-T?
?E?-------X--X-B--B-E-E--?-B--oM-|B-TM-XM-----?M|o?T-M-B-BX?-XXM-E--oE----E---E--|-----|ME--EE?-E---XEX-?--BX?--T--E-o-X----|-B-X|----|-----M---|-MBoEM-E-----MTX-Bo-B-o-XT--EXMB?M-EoB-o--|o-|--?----Bv
E--T-|-?o-oX--MEE--|--X?EE-T?EE-M-EBoM-------|T-----BM--------?--B--?--T-o-----o-BM-|T--To-?--?--T|M---B-||XBX-B-B|--XM-T--?-T-T-|B-o--T--M--MXX-MT----|--To-o------------oToET-oMT-oo-M-M-||o|T---oX--E
M-B-E--M--E-ME-|-EM-BM--o-o-BX?BE-MX------M-M?-|-E--o-TMMXTTXM--E-ME--?-X--TE-T----B---X--E--TM-o-----o-oB--oX||---o--Xo--TXEo---EEM?TX-||?BMB-?-o----X----T--TX--MM--X--?-XXT-B-M-o-T-M-X|-o--o----X--B
Mo?|MB|o---?--T-BB?--M-----?--|------T--MB-TXoo--M--TM-EET--E?-T--|-EoXoE--X|--T-BEB?---M--M---B--BE-?E-BT--E--|-|B?T-M-E|-|-E-|-|MT?B?E--??T-BTME-M-T?--oM??XoTT-TX-X|X--B-----o-E------?E----?-?T---E?
?T-B--To----T--E---o?-XT-XM-|M---?--To--M--oEBoo--X-|-?-T-|M--T?-|-M----B|-MM-|EB-M-------MTE-o-?|-X?|oEXXE-EE?--??--M-|------ETE----?X--B---T-B-X--|-|-M--XM---X-T--|ETT-E?--M--------M?B--B?---E--|--|
|-|EXT--|?-|-?MT--|-M-----o?o|TXM--T|?--?-oEo--|oT?o--o|--o?-|M-??E-MM--B-XBX--M--M----------B-|-?X-TBMM?-E-X--oEM-----------M-EXoM--o?|-ME--|?E--?--X-?-X-M-E-M----B|BM---ET--?-M|---?-?-?B--BTo-o|Eo-B
X---oT-o-??-?-T--E|X-XBT--M--T-E----|BTE-EoX--o-M???--|TM--TX----XXE--B-EEXTTB-E-B-o-oB---MX--X--TT---X|-o----X-T--X--E-o-|B----B-E-o??B-----B?B-?EE----|-X|o---ETT|M--?--E?BM-----o--MB--TXT-o|BX-|-?-?
mM-Eo-MB-E--BTo--?-TTT-------BT|-M---|----?----|XT--M?TB-?---ME---TE--X??-XE-|----E-------?X--X--XTTM-oT-o--M-MoT-B-----XB-|-B--TME-MBETT?XTTME-|---o---E----E-----|-MB---?E--o--E-M--oX-XB-----E?Mo-ET|
XXXXXXXXXXXXXXXXXXXXXXXXXXXXXXXXXXXXXXXXXXXXXXXXXXXXXXXXXXXXXXXXXXXXXXXXXXXXXXXXXXXXXXXXXXXXXXXXXXXXXXXXXXXXXXXXXXXXXXXXXXXXXXXXXXXXXXXXXXXXXXXXXXXXXXXXXXXXXXXXXXXXXXXXXXXXXXXXXXXXXXXXXXXXXXXXXXXXXXXX
