---oBXB----|------?----X--T-?-o---M-MET-TMoo---T|-B-|XE-?E-?oo-??M-T-E-T?-?-BE-TM-X-X-MEETo-X--?Mo---o-?To|--M-B--?X-T--B-TTM----|o-X--T?BM-E--E--T-----o-???E------B-|X-E-BT-?--E---?-B--|o-?XM-B--|-|-
---|ME--B--EE-|o--?--TE--||---?----M----XoE?-MB-B-T|-oE----MB?|X|--T?XX??---E-T?---TTM-BE--?oEE?|-T--?T----E--EM--E?X-?--o??--M-T-----oTo?X----TB-?----X--?--B--MT?TEMB-------E-TX--|--o-B-X----E-ETT---
---T-E--M?--EX-BT-XET-MM-B----o--?E--TBo---XE-B|X---BM-T?E-----E-T?-X|-E---|XX-E-MT--|-?M----?E--o-M----MM-XBB-B--|?----T--MET-X|?--X--|M---B----T----||-X-XEM--|-M--X?-?E-BT|----T--TT-Xo-?E|--XT-M-BB-
--X|-XEX-|-??-X-MMBT--Xo--?|T---?T-B-o?oB-M-E-E-X------?------MM---|---?--T-E-EX----??--|--o-?oM|-TM---EX-M-o-?-TE?-?-T--BE?oXX-E-TE---|oE----XoXT--|------E--X----MMXMB-ooEMT---o----XB---?X--BMT---|--
-EBT----?M---B-EB-|MX--EEo------E-E--?X--Eo?--M---ET-------T--oo---o?--B--E-ToTB-|o--|?--X--M--M--o|-T--ME|??---M--E?BX---T|BB---E-X--E-T-X--TM---X------B-?E--oM?-TB--?-T-E------T|--MBT-X-o-XoXB|-oBE-
-?--M-|--|-o-X-------o--?-M-T-EB?B--||--?-?--X----B|-EB|-?---To--?M??E|-|T?--T-Bo--------M--TE-----oo-----o---?B-?--oMT-?B----MB----o?-|oB-Eo-oEX-M?TME?B-o?--M|--o-B|--|--B---?-T-TBX---?----T----o-?M-
---|?E-E--M-T--??B---T--||?E?|-B--oo-BB-E-|M----o------Eo-X|B-E--o-oo---o--B---o--ToE--M?X-BEM?|-B----o--X-----E--o--?---------EE-?-T-E-E-|-?oo-o--E-?---T--B|-B----?B----|B--TT--MEE--EE--Bo-T---XT|---
-|---?XE----M-|B----?|--T------X-BBX---X--To-|MTTEB----B--X----M-ET--X--Boo-----|----X|T-?---X--o-M-o-Bo-EB---X?-E------BE--BEB----|--o----|-----Xo--MT?o--MM--E---|oE--T---M--BBT-|----o---EEoB?-M-M--v
---B?|?--X-----E---X---BMX-T-MEoM-BT-X-----X-?o--E-?--?----------M--?-EMX?|-MT---o------o|-EX--BT--Mo-M----|--EBo|-XX-?-EB|--X-XE|XB--ET--o-o|-BE-XoXXM----o--X--E-|?-?-|-B-o---EM-ooo-|E-?--X-TM-X-T-Xf
-?X----EXBE|-?--T-?---Boo-|?M-M|---BEX----X--M-oMBM--|E-T-?-X?-----EBM--BT-T--T----B-|----X-T-T-----??M--X-Mo-|--|MB|--|--M-oo|B-|-M--X-?|??------?-|EE---o---BB-----?-M---M?X-|--|XX-?-----ToX-T------f
-------o--X?--o--B--E------EBTEoBE-oB--BM--oXMo--M------E?B--?B----M|-X-oM--M-TT-|--?--B-X--------B?--?E--X?E-T--XE?--M--T--T----?--B-XB-M?TB-BMo|--TTT-|ooM?-oTT-E-M-MXE--?---|M-E---T---B-o-T?-------f
--E-|--oB?--E-----Xo--X---MXXM-------E-|M----XooM-------E-o-|-|-|----TB--ToEo-|-M-E--?B----o--o----E?----X----?--------BX-XB-B-TX-|-MB|E------T-|--o-o-----E--?X----?--T---oX-MM-?MM|M?XEM-TToo--|--||-f
--|-TT-T|-o--?-|--|B-----TB?-T------|--B?-T-o--Eoo?--Eo---M??----?---E---EB?-o---X-X-B|-o------|-||ME----XE-X--o?M--B-TT------E-X-XMTBE|----XM?ME-?-EME-o-Bo----T-T--??---|---T?|oX-----oB-B-XBToEoT--Bf
--BX---o------E--EEMMX--M-M--E--EooM||E-EE--XXTB--|-?X|T------------M-B|--ET-B?----M---MTBE|-?--oMToE-E|-E-M|--M-T--B-||-?-X-ToXM-|B---MT--M-B?B---B-o-E|---M---|T-o-TT-?-|-XE--E--XM---X|-o----T-oB---f
mXoMM-M------o----oo-T|M-?---BM-M-M--|B?-|-T-|T------ET|-??-T----?-X-BE-B----|-T?-X-TM|oTM---|M----TM?oTE-T-M-------X---M?-|-|-o-M|MMo---?--T-----EoX---E-EX--M--o--|-M-E---X?o--oM-o-E|M----MX-ET-XE--X
XXXXXXXXXXXXXXXXXXXXXXXXXXXXXXXXXXXXXXXXXXXXXXXXXXXXXXXXXXXXXXXXXXXXXXXXXXXXXXXXXXXXXXXXXXXXXXXXXXXXXXXXXXXXXXXXXXXXXXXXXXXXXXXXXXXXXXXXXXXXXXXXXXXXXXXXXXXXXXXXXXXXXXXXXXXXXXXXXXXXXXXXXXXXXXXXXXXXXXXX
