-----???---------------------------------------------???????------X-----------------o----?--------------------------------------------------------------------------------------------------------------
--------?-----------------------o----M------------------------------------------------------------------------------------------------------------------------------------------------------------------
--------------------------------------------------XXXXXXX----------------------------------------------------------M------------------------------------------------------------o-----------------------
-------------------------------------XXXX------------------------o-------------------X--------------------------------------------------------------?---------------------------------------------------
--------------------???-----------T-----------------------------------------------------------------------------------------------------------------------X---------------------------------------------
-------------------------XXXXX----|----------------------------------------X---------------------------------------------------------------------????????------------------X----------------------------
----------------------------------|-------------------------?--------M----XX-----o----------------------------------------------------------------------------------------XX----------------------------
--------------------------B-------|------------T--------o----------------XXX---------------------------------------------------------------------------------------------XXX---------------------------v
-------------------------?--------|------------|------------------------XXXX--------------------------------------------------------------------------------------------XXXX---------------------------f
----------------------------------|------------|-------------------M--XXXXXX-B-----------------------------------------------------------------------------------------XXXXX---------------------------f
----------------------------------|------------|---------------------XXXXXXX------------------------------------------------------------------------------------------XXXXXX---------------------------f
----------------------------XXXXX-|---------?--|--------------------XXXXXXXX-----------------------------------------------------------------------------------------XXTXXXX---------------------------f
-------------------------o--------|----T-------|---------XXXXX-----XXXXXXXXX-----------------------T---------------------------------T-----T------------------------XXX|XXXX---------------------------f
----------------------------------|----|-------|----o-------------XXXXXXXXXX-----------------------|-----------------T---------------|-----|-----------------------XXXX|XXXX---------------------------f
m-------o--------------X------E-E-|----|-------|-------------E---XXXXXXXXXXX---------------E-------|-----------------|---------------|-----|----------------------XXXXX|XXXX---------------------------X
XXXXXXXXXXXXXXXXXXXXXXXXXXXXXXX---|XXXX|XX-----|--X-----XXXXXXXXXXXXXXXXXXXXXXXXX----XXXXXXXXXXXXXX|XXXXXXXXXXXXXXXXX|XXXXXXXXXXXXXXX|XXXXX|XXXXXXXXXXX------XXXXXXXXXX|XXXXXXXXXXXXXXXXXXXXXXXXXXXXXXXX
