-Xo--T-----|X-----?-X----BE-??---T--XE?XXB-----o---T-XE---oo-o??-M--?E-TM----TET-----?M-ET-?M--?-EM----?TT--?-B--E-----E--T-------oM-o-T|E-X|--Mo--BE?-?o--??BXoT?--B--X?o-------BXB-?-MX?XT-E---B--|---
-o-T--B--?B-XM----T-X-TE-|E-M----------|-B---MTTBMo|-XE-----B-|-M----XT??MX|o--------?-TEX-?-X--X-B-XETE---EMMEB--E--|TBEo-E--M-|-E?--B-----M-TTB|-o-TT-?T|-----B--TE-T-M--o--XT--|?BMTo-B-ETMToE-TTT---
---E|TB--??--T|--|TEoTXMM-o-----MTE---B-E--XB-?|B?----|-T-EB|o--o--o--------X--XM|-E--MT?--o-TE?--?-------E--BMM--?||-o-TM--E--?X|--X-?---o-BT|B-B-Eo?||oX---|-TE--M----|---o-------T-|-|?--E-X--XE--B?-
----TTMX---??-B---Eo--X--o-B-o-------E?oo-M-XTB-?M--B---B|-----|?--------TEM-To--To-X?o?---oBBo-----B--|T--|oM--TX|TT---To?o?BE-o--X----oX-||--|-----XX-|X|E-BB-?----X--?ooE--?X-o---E---M-?----M--E-B--
-BB?----E?--M----?|--M-M-oo-B|E-E-|-M---E?EBTXB--ToM-o-----T--oE--T-?--o---T-T-BX|--X---T-o-|-|----?------|-?-B-EoXMM-----MM-|?-|XE--T?--B-BE-B?XT----E---T?-o|----BBB-|------B-EET--XM-T--XX-EXX-o-oB--
--?--B|-?|-M-Xo--|X--o--?-M-T-EB--M-M--M-|EM|E---MB--o---------E--MM-E-EE|?--T?Bo-MMX-M-----ME---X-oo----Eo-XEMB-TB-------MT--?---|-B?-M|B---XM--MM-T-TX--X----XX-|--|o-oB|B--|M-T-T-X---?X-|------|----
---E---|---BT---ETE-Xo-?---E---B--ooXMo----|-|-?oTXBo--ET-TEBoX-X--X----|-?|---o|?T-|-oMBM-o-T?|-B--?-o--Eo?EX-|---o--Xo-o--EMB---?o---o---B-T--o-X--?----Eo---BX---o--------XE|--E???-E--|TE------T|-?-
-E-X----B----T-B----?---T--------|-ETM--M?---|ME?E?T-TTB--o?-MBM--------B?------X|----B|MEE-?-T-o-X--EBT?--B-------o-Bo---|o|?--T|T---T-----X---E-?-oM---?--M-EE--EoE-T-To--M-o-o-|----Bo-|E-E|??-|MM?-v
-o-----?---?T---M-X----|?E---M|o?X|-o-o-M--M-?T?|E--Mo?BB--E--?M-B--E-E?Xo--o----B--o---B||E---B-X?----B--BTE-EBo-|X---?--?XoT----MT-M-T-----E|B-?X-o|----T|-|E------|E---BT--Bo-o-----o---|-oTT--Xo-XXf
-|-----M-E-----|-|M--?X-o--TT-o|MX--XX-T-T-?Bo-TMEX---|-M---M|E-X-----M-B-?|--T-T-|--|MX-oX---M------|B--X-M-X--o|-E---T--MXBEEB-E------?B--T--?--?-|EE----TM-MX-----?XM----?TX--X-X|T---ME---EM----X--f
-----B-??B--|ETo---o-o--|--?--Eo--?-BT-Moo-o-Mo--M-|-?--ET-TE-B-o------Mo---|--X-B--B-B-o|-MB--E-?-oX--------M--T||BM--?-T---ET|--M-B-?|EM-?--BET----T-B|oo?EX-MBE----|--MBE-|-X-oE|M-------oE-M-?TXX--f
----M---B||BEEXEB-----oT|XB-EM|------E---M|B||-?T-X--|-----?|-o-B|-E-X---TEE?o-|o---------BoXEoMX--|?-----E-E-MBM--XBXBB---B-o-TE|--M-|-oEX--?T-|----o-?MM-EM-?XX||--TXT---oXE---?------E---X|E-T|-----f
--|B----T------E------BT--MTE-|--?o-B?--T-----T-T----EB---M-E-T-?----?M--T--o--M-B--|--T----o--|--|XTB-B?--?B--oE---B---|---X?E-|-XMToM-o------EE|B-TE----BM--E-------|X--|--T-|MoM-----X--BMoE--?-T?-|f
--|X-oo------?--?E|BXX-----?-T?---o--B-E-Mo-?T--M---E-|-|-M-X------E|-B---X--B-----X--|M|------MMM-o-B||-o--M-BM-T--E|E--?M-EMo??----TMM-|B-Xo----MM|oBEo--Bo-BX------XBo--?----T-|o--M-X-TXT---T--B--Ef
mB-E--MB-MM---oE---oT----M--E-?--M----??--oT-|MM--TEoEEM--?--BE--?ME??B-?----??---o|-E-oT----|----TT--MTE-TMM--o?-BMX---X--|-Bo?--B------?MXE?----o-X-----EX---MBX-?|M--E|-E--XT--M-oM-|-X-M--BEE-M-E-|X
XXXXXXXXXXXXXXXXXXXXXXXXXXXXXXXXXXXXXXXXXXXXXXXXXXXXXXXXXXXXXXXXXXXXXXXXXXXXXXXXXXXXXXXXXXXXXXXXXXXXXXXXXXXXXXXXXXXXXXXXXXXXXXXXXXXXXXXXXXXXXXXXXXXXXXXXXXXXXXXXXXXXXXXXXXXXXXXXXXXXXXXXXXXXXXXXXXXXXXXX
