--------------------------------------------------------------------------------------------------------------------------------------------------------------------------------------------------------
-------B------------------------------------------------------------------------------------------------------------------------------------------------------------------------------------------------
-------------------------------------------------------------------------------------------------------------------------------------------------------------------------------------o-M----------------
--------------------------------------------------------------------------------------------------------------------------------------------------------------------------------------------------------
--------------------------------------------------------------------------------------------------------------------------------------------------------------------------------------------------------
---------o----------------------------------------------------------------------------------------------------------------------------------------------------------------------------------------------
--------------------------------------------------------------------------------------------------------------------------------------------------------------------------------------------------------
----------o--------------------------------------------------------------------------------------------------------------------------------------------------------------------------------------------v
----------T--------------------------------------------------------------------------------------------------------------------------------------------------------------------------------?-----------f
----------|--------------------------------------------------------------------------------------------------------------------------------------------------------------------------------------------f
----------|--------------------------------------------------------------------------------------------------------------------------------------------------------------------------------------------f
----------|--------------------------------------------------------------------------------------------------------------------------------------------------------------------------------------------f
-----?????|----------------------------------------------------------------------------------------T----------------------------------------------------------------------------------X----------------f
----------|----------------------------------------------------------------------------------------|------------------------------------------------------------XXX-------------------XX---------------f
m----E----|----------------------------------------------------------------------------------------|----------------------------------------------------------------------------------XXX----E---------X
XXoXXXXXXX|-----XXXXXXXXXXXXXXXXXXXXXXXXXXXXXXXXXXXXXXXXXXXXXXXXXXXXXXXXXXXXXXXXXXXXXXXXXXXXXXXXXXX|XXXXXXXXXXXXXXXXXXXXXXXXXXXXXXXXXXXXXXXXXXXXXXXX----XXXXXXXXXXXXXXXXXXXXXXXXXXXXXXXXXXXXXXXXXXXXXXXX
