--------------------------------------------------------------------------------------------------------------------------------------------------------------------------------------------------------
----------------------------------------------------------------------------------???????-------------------XX-------------B----------------------------------------------------------------------------
-------------?-----------------------------------------------------------------------------------------------------------------------------------------M------------------------------------------------
--------------------------------------------------------------------------------------------------------------------------------------------------------------------------------------------------------
----------------------------------------------------------------------------------------------------------------------------------------------------X---------------------------------------------------
---------------------------------------------------------------------------------------------------------------------------------------------------XX---------------------------------------------------
--------------------------------------------------------------------------------------------------------------------------------------------------XXX---------------------------------------------------
----------------------------------------------------------------------------------------M--------------------------------------------------------XXXX-------------?------------------------------------v
----------------------------------------------------------------------------------------------o-------------------------------------------------XXXXX--------------------------------------------------f
-----------------------------------------------------------------------------------------------------------------------------------------------XXXXXX--------------------------------------------------f
----------------------------------------------X-----------------------------------------------------------------------------------------------XXXXXXX--------------------------------------------------f
----------------------T----------XXXXX-------XX----------------------------------------------------------------------------------------------XXXXXXXX--------------------------------------------------f
----------------------|---------------------XXX----------------------------------------------------------------?----------------------------XXXXXXXXX--------------------------------------------------f
----------------------|--------------------XXXX--------------------------------------------------------------------------------------------XXXXXXXXXX--------------------------------------------------f
m---------------------|-E-----------------XXXXX--------------------------E---------------------------E----E-------------------------------XXXXXXXXXXXBBB--------X-------E---E-----X----E---------------X
XXXXXXXXXXXXXXXXXXXXXX|XXXXXXXXXXXXXXXXXXXXXXXXXXXXXXXXXXXXXXXXXXXXXXXXXXXXXXXXXXXXXXXXXXXXXXXXXXXXXXXXXXXXXXXXXXXXXXXXXXXXXXXXXXXXXXXXXXXXXXXXXXXXXXXXXXXXXXXXXXXXXXXXXXXXXXXXXXXXXXXXXXXXXXXXXXXXXXXXX
